#e########
# ### ####
#     ####
##  ######
##  ######
###   ####
##   #####
##  ######
##      ##
#######s##